1111111111111111111
1C00010000C00000001
1C00E10P00C00000001
1C00101000C00001001
1C00000000C00000001
1C00000000C00C00001
1C00001000C00C01001
1C00000000C00C00001
1C00000000C00C00001
1C00001000C00C01001
1111111111111111111