111111111111111111111111111111111111111
10E000000100000000000000000000000000001
10000000C100000000000000000000111100101
100001111111111110111111100111111101001
101111000001000000100000101100000101101
100000010101011111111110100001110101001
100111010111010000000000101111010111011
100100000000010111111111101000010000001
100101011111110100010001101011111101101
1001010000000100010001000010000000001P1
111111111111111111111111111111111111111