1111111111111111111111111111111111
1E0000000000000C00000C000000000001
1020020200200000202002000000020201
1020020020202020002002000000020201
1A0000000C00C0000000000000000000C1
100000000000000C00000C00000A000001
1020020200200000202002000000020201
1020020020202020002002000000020201
1P0000000C00C0000000000000000000C1
1111111111111111111111111111111111